Posição;Foto;Cavaleiro;Lutas;Pontos;Vt. Favor;Vt. Contra;SC
1º;;Ikki de Fênix;;10;108;65;43
2º;;Jabu de Unicórnio;;9;109;49;60
3º;;Shiryu de Dragão;;9;121;79;42
4º;;Hyoga de Cisne;;9;94;71;23
5º;;Shun de Andrômeda;;7;107;63;44
6º;;Seiya de Pégaso;;6;85;100;-15
7º;;Geki de Urso;;3;76;97;-21
8º;;Ichi de Hidra;;3;56;101;-45
9º;;Nachi de Lobo;;3;61;116;-55
10º;;Ban de Leão Menor;;0;38;114;-76
