Posição;Foto;Cavaleiro;Lutas;Pontos;Vt. Favor;Vt. Contra;SC
1º;;Hyoga de Cisne;3;9;71;40;31
2º;;Ikki de Fênix;3;7;77;42;35
3º;;Jabu de Unicórnio;3;6;76;39;37
4º;;Shiryu de Dragão;3;6;71;49;22
5º;;Seiya de Pégaso;3;6;55;50;5
6º;;Shun de Andrômeda;3;4;72;53;19
7º;;Geki de Urso;3;3;45;62;-17
8º;;Ichi de Hidra;3;3;46;66;-20
9º;;Ban de Leão Menor;3;0;28;81;-53
10º;;Nachi de Lobo;3;0;26;85;-59
