Posição;Foto;Cavaleiro;Lutas;Pontos;Vt. Favor;Vt. Contra;SC
1º;;Jabu de Unicórnio;2;6;55;13;42
2º;;Hyoga de Cisne;2;6;45;21;24
3º;;Shun de Andrômeda;2;4;53;27;26
4º;;Ikki de Fênix;2;4;46;29;17
5º;;Shiryu de Dragão;2;3;45;28;17
6º;;Seiya de Pégaso;2;3;33;32;1
7º;;Geki de Urso;2;3;27;40;-13
8º;;Ichi de Hidra;2;0;21;48;-27
9º;;Nachi de Lobo;2;0;13;54;-41
10º;;Ban de Leão Menor;2;0;10;56;-46
