Posição;Foto;Cavaleiro;Lutas;Pontos;Vt. Favor;Vt. Contra;SC
1º;;Shun de Andrômeda;1;3;31;5;26
2º;;Jabu de Unicórnio;1;3;28;5;23
3º;;Ikki de Fênix;1;3;24;7;17
4º;;Geki de Urso;1;3;19;13;6
5º;;Hyoga de Cisne;1;3;20;16;4
6º;;Shiryu de Dragão;1;0;16;20;-4
7º;;Ichi de Hidra;1;0;13;19;-6
8º;;Seiya de Pégaso;1;0;7;24;-17
9º;;Nachi de Lobo;1;0;5;28;-23
10º;;Ban de Leão Menor;1;0;5;31;-26
